strategic_region={
	id=27
	name="Mexico"
	provinces={
		17 52 62 64 103 124 135 172 191 195 225 230 248 252 286 293 301 311 324 327 328 345 351 353 359 367 374 375 378 403 410 411 425 442 449 451 459 466 470 475 510 512 517 521 544 549 614 617 641 673 690 695 699 722 723 747 748 762 798 799 804 805 812 816 826 843 858 861 888 911 926 931 956 987 1006 1037 1040 1055 1065 1079 1080 1083 1094 1105 1106 1120 1126 1156 1159 1167 1172 1180 1185 1199 1202 1230 1239 1248 1270 1280 1283 1291 1300 1322 1323 1347 1359 1370 1377 1385 1391 1431 1432 1496 1499 1503 1506 1509 1514 1521 1524 1527 1536 1544 1569 1574 1590 1595 1596 1600 1603 1605 1616 1622 1624 1625 1627 1629 1640 1644 1645 1662 1669 1672 1682 1704 1709 1716 1723 1728 1729 1750 1764 1777 1779 1783 1787 1832 1851 1852 1858 1868 1881 1884 1889 1891 1907 1918 1922 1958 1970 1983 2003 2016 2020 2038 2049 2059 2063 2078 2082 2084 2087 2154 2164 2170 2196 2202 2215 2222 2238 2247 2250 2256 2263 2267 2297 2298 2302 2313
		2325 2328 2338 2348 2350 2353 2385 2393 2397 2400 2402 2436 2437 2438 2443 2449 2452 2455 2466 2470 2486 2490 2499 2501 2506 2523 2566 2578 2581 2591 2597 2627 2641 2654 2660 2662 2666 2681 2683 2688 2699 2706 2718 2720 2731 2741 2743 2764 2769 2770 2776 2799 2803 2825 2833 2835 2849 2868 2869 2882 2905 2907 2913 2930 2936 2945 2957 2958 2964 2966 2968 2971 2973 2977 2985 3002 3020 3026 3035 3036 3049 3065 3095 3102 3126 3140 3157 3172 3173 3176 3189 3193 3197 3198 3205 3234 3236 3244 3247 3256 3258 3265 3273 3275 3278 3279 3283 3291 3295 3331 3342 3350 3352 3355 3367 3381 3382 3386 3390 3391 3393 3407 3430 3432 3435 3437 3444 3451 3458 3465 3467 3477 3483 3492 3496 3498 3514 3522 3525 3532 3534 3537 3548 3557 3584 3598 3600 3607 3654 3661 3671 3687 3688 3707 3716 3717 3732 3738 3739 3741 3746 3749 3755 3759 3764 3767 3776 3787 3790 3797 3799 3803 3819 3823 3825 3835 3838 3845 3860 3864 3874 3876 3890 3908 3915 3916 3930 3932 3945 3960 3974 3982 3996 3997 3999 4000 4003 4005 4013 4020
		4023 4025 4029 4038 4055 4058 4063 4064 4072 4076 4082 4083 4098 4104 4111 4118 4135 4137 4143 4151 4155 4164 4170 4177 4192 4196 4210 4216 4253 4256 4263 4266 4269 4270 4298 4308 4310 4314 4316 4327 4329 4338 4344 4357 4359 4362 4363 4365 4371 4389 4390 4392 4393 4396 4401 4412 4424 4431 4435 4447 4467 4469 4479 4491 4495 4500 4505 4512 4515 4524 4528 4538 4540 4548 4553 4556 4559 4567 4568 4574 4582 4599 4602 4604 4609 4615 4620 4622 4623 4634 4635 4639 4668 4677 4680 4685 4697 4700 4702 4721 4727 4728 4734 4736 4753 4754 4756 4759 4765 4772 4781 4785 4791 4800 4814 4815 4835 4847 4852 4853 4871 4873 4876 4878 4880 4889 4903 4910 4917 4918 4919 4928 4934 4944 4951 4954 4956 4960 4961 4962 4965 4966 4967 4977 4984 4985 4991 4993 5005 5016 5021 5035 5039 5040 5052 5060 5072 5073 5081 5086 5089 5092 5101 5104 5105 5121 5137 5151 5155 5158 5167 5180 5183 5185 5186 5191 5203 5206 5209 5216 5217 5221 5225 5227 5241 5243 5249 5252 5254 5258 5259 5269 5277 5291 5305 5310 5319 5322 5328 5332
		5333 5335 5339 5343 5347 5349 5360 5361 5363 5368 5371 5386 5389 5394 5396 5406 5413 5419 5422 5428 5431 5439 5453 5454 5455 5456 5464 5481 5500 5504 5510 5512 5514 5531 5538 5539 5547 5549 5552 5556 5560 5563 5564 5565 5571 5574 5575 5584 5589 5593 5594 5598 5615 5617 5623 5631 5635 5642 5648 5651 5656 5660 5682 5686 5694 5700 5702 5708 5709 5717 5738 5739 5741 5746 5752 5753 5758 5765 5766 5777 5778 5781 5788 5804 5810 5813 5818 5823 5836 5845 5849 5857 5875 5880 5886 5889 5895 5897 5916 5917 5925 5926 5928 5932 5954 5958 8179 8184 8198 8200 8214 8225 8226 8235 8239 8255 8263 8270 8271 8286 8294 8300 8304 8317 8321 8322 8333 8334 8335 8338 8348 8350 8351 8355 8360 8363 8364 8371 8378 8381 8382 8392 8396 8397 8400 8401 8404 8408 8416 8418 8421 8423 8425 8429 8431 8434 8436 8437 8438 8439 8440 8443 8444 8446 8447 8448 8455 8456 8458 8461 8462 8464 8466 8467 8468 8469 8470 8474 8475 8476 8477 8478 8479 8480 8481 8483 8484 8485 8486 8487 8489 8490 8491 8492 8493 8494 8497 8498 8499 8501
		8502 8503 8504 8505 8506 8507 8508 8509 8510 8512 8513 8514 8515 8517 8518 8519 8521 8522 8523 8524 8525 8526 8527 8528 8529 8530 8531 8532 8533 8535 8536 8537 8538 8539 8540 8541 8543 8544 8545 8549 8550 8551 8552 8553 8554 8555 8556 8557 8558 8559 8560 8562 8563 8564 8565 8566 8567 8568 8569 8570 8571 8572 8574 8575 8576 8577 8578 8580 8582 8583 8584 8586 8588 8590 8591 8593 8594 8595 8598 8599 8601 8604 8606 8607 8609 8612 8619 8620 8621 8627 8631 8632 8634 8638 8640 8643 8644 8648 8651 8652 8655 8656 8658 8659 8664 8665 8669 8670 8673 8675 8676 8677 8678 8679 8680 8683 8684 8685 8686 8688 8690 8691 8695 8696 8697 8698 8699 8700 8702 8704 8705 8707 8708 8709 8710 8711 8712 8713 8715 8716 8717 8718 8719 8720 8721 8722 8723 8724 8725 8726 8727 8728 8729 8730 8731 8732 8733 8734 8735 8736 8737 8738 8739 8740 8741 8742 8743 8744 8745 8746 8747 8748 8749 8750 8751 8752 8753 8754 8755 8756 8757 8758 8759 8760 8761 8762 8763 8764 8767 8768 8769 8770 8771 8772 8774 8775 8776 8777 8778 8779
		8780 8781 8784 8785 8786 8787 8788 8789 8790 8791 8792 8793 8794 8795 8796 8797 8798 8799 8800 8801 8802 8803 8804 8805 8806 8807 8808 8809 8810 8811 8812 8813 8814 8815 8816 8817 8818 8819 8820 8821 8822 8823 8824 8825 8826 8827 8828 8829 8830 8831 8832 8833 8834 8835 8836 8837 8838 8839 8840 8841 8842 8843 8844 8845 8846 8847 8848 8849 8850 8851 8852 8853 8854 8855 8856 8857 8858 8859 8860 8861 8862 8863 8864 8865 8866 8867 8868 8869 8870 8871 8872 8873 8874 8875 8876 8877 8878 8879 8880 8881 8882 8883 8884 8885 8886 8887 8888 8889 8890 8891 8892 8894 8895 8896 8897 8898 8899 8900 8901 8902 8903 8904 8905 8906 8907 8908 8909 8910 8911 8912 8913 8915 8916 8917 8918 8919 8920 8921 8922 8923 8924 8925 8926 8927 8928 8929 8930 8931 8932 8933 8934 8935 8936 8938 8939 8940 8941 8942 8943 8944 8945 8948 8949 8954 8956 8958 8960 8961 8962 8964 8968 8969 8971 8972 8973 8974 8975 8980 8981 8982 8983 8987 8988 8992 8994 8995 9003 9004 9005 9006 9011 9016 9018 9019 9020 9023 9026 9027 9028 9029
		9030 9031 9032 9035 9036 9037 9042 9043 9044 9047 9050 9051 9052 9053 9054 9056 9059 9060 9061 9063 9067 9068 9069 9071 9072 9073 9074 9076 9077 9078 9079 9081 9085 9086 9089 9090 9099 9101 9105 9106 9107 9112 9116 9121 9125 9128 9131 9135 9143 9149 9150 9151 9156 9159 9166 9176 9182 9600 9603 9625 9627 14541 14938 14941 14943 14945 14946 14947 14948 14950
	}
	weather={
		period={
			between={ 0.0 30.0 }
			temperature={ 6.0 21.0 }
			temperature_day_night={ 8.0 -8.0 }
			no_phenomenon=0.910
			rain_light=0.050
			rain_heavy=0.010
			snow=0.000
			blizzard=0.000
			arctic_water=0.000
			mud=0.040
			sandstorm=0.030
			min_snow_level=0.000
		}
		period={
			between={ 0.1 27.1 }
			temperature={ 7.0 23.0 }
			temperature_day_night={ 8.0 -8.0 }
			no_phenomenon=0.920
			rain_light=0.040
			rain_heavy=0.000
			snow=0.000
			blizzard=0.000
			arctic_water=0.000
			mud=0.030
			sandstorm=0.040
			min_snow_level=0.000
		}
		period={
			between={ 0.2 30.2 }
			temperature={ 9.0 26.0 }
			temperature_day_night={ 8.0 -8.0 }
			no_phenomenon=0.900
			rain_light=0.040
			rain_heavy=0.000
			snow=0.000
			blizzard=0.000
			arctic_water=0.000
			mud=0.030
			sandstorm=0.060
			min_snow_level=0.000
		}
		period={
			between={ 0.3 29.3 }
			temperature={ 12.0 28.0 }
			temperature_day_night={ 8.0 -8.0 }
			no_phenomenon=0.870
			rain_light=0.060
			rain_heavy=0.010
			snow=0.000
			blizzard=0.000
			arctic_water=0.000
			mud=0.050
			sandstorm=0.060
			min_snow_level=0.000
		}
		period={
			between={ 0.4 30.4 }
			temperature={ 14.0 29.0 }
			temperature_day_night={ 8.0 -8.0 }
			no_phenomenon=0.800
			rain_light=0.120
			rain_heavy=0.040
			snow=0.000
			blizzard=0.000
			arctic_water=0.000
			mud=0.100
			sandstorm=0.040
			min_snow_level=0.000
		}
		period={
			between={ 0.5 29.5 }
			temperature={ 15.0 28.0 }
			temperature_day_night={ 8.0 -8.0 }
			no_phenomenon=0.640
			rain_light=0.240
			rain_heavy=0.100
			snow=0.000
			blizzard=0.000
			arctic_water=0.000
			mud=0.180
			sandstorm=0.020
			min_snow_level=0.000
		}
		period={
			between={ 0.6 30.6 }
			temperature={ 14.0 27.0 }
			temperature_day_night={ 8.0 -8.0 }
			no_phenomenon=0.610
			rain_light=0.260
			rain_heavy=0.120
			snow=0.000
			blizzard=0.000
			arctic_water=0.000
			mud=0.200
			sandstorm=0.010
			min_snow_level=0.000
		}
		period={
			between={ 0.7 30.7 }
			temperature={ 14.0 27.0 }
			temperature_day_night={ 8.0 -8.0 }
			no_phenomenon=0.610
			rain_light=0.260
			rain_heavy=0.120
			snow=0.000
			blizzard=0.000
			arctic_water=0.000
			mud=0.200
			sandstorm=0.010
			min_snow_level=0.000
		}
		period={
			between={ 0.8 29.8 }
			temperature={ 14.0 26.0 }
			temperature_day_night={ 8.0 -8.0 }
			no_phenomenon=0.640
			rain_light=0.240
			rain_heavy=0.110
			snow=0.000
			blizzard=0.000
			arctic_water=0.000
			mud=0.180
			sandstorm=0.010
			min_snow_level=0.000
		}
		period={
			between={ 0.9 30.9 }
			temperature={ 12.0 25.0 }
			temperature_day_night={ 8.0 -8.0 }
			no_phenomenon=0.790
			rain_light=0.140
			rain_heavy=0.050
			snow=0.000
			blizzard=0.000
			arctic_water=0.000
			mud=0.100
			sandstorm=0.020
			min_snow_level=0.000
		}
		period={
			between={ 0.10 29.10 }
			temperature={ 9.0 23.0 }
			temperature_day_night={ 8.0 -8.0 }
			no_phenomenon=0.900
			rain_light=0.060
			rain_heavy=0.010
			snow=0.000
			blizzard=0.000
			arctic_water=0.000
			mud=0.050
			sandstorm=0.030
			min_snow_level=0.000
		}
		period={
			between={ 0.11 30.11 }
			temperature={ 7.0 21.0 }
			temperature_day_night={ 8.0 -8.0 }
			no_phenomenon=0.910
			rain_light=0.050
			rain_heavy=0.010
			snow=0.000
			blizzard=0.000
			arctic_water=0.000
			mud=0.040
			sandstorm=0.030
			min_snow_level=0.000
		}
	}
}
