5 85 5450 6552 6576 3553 6630 3993 2159 6690 6736 2403 701 2507 6832 577 6893 6919 6942 3868 6948 5087 1395 7020 7023 7057 5846 1341 2807 7134 7156 3721 7233 2798 7281 4272 7322 5799 4701 3847 7467 4626 5961 2091 1296 7617 2305 3301 4869 5264 7766 7781 7800 5497 2269 7862 1224 1967 7947 3664 7984 8034 3947 8058 8081 1537 8127 8152 4306 8199 5963 8265 5903 8293 5559 8330 8341 4845 8386 3842 5009 4191 4397 8459 527 8473 3964 
2 12 5561 6713 1352 6753 6767 4265 275 5382 6861 1555 1935 6948 
2 7 6724 6731 3539 6760 6767 606 2895 
2 9 6713 1928 5937 491 2895 6807 6825 769 6832 
2 12 2719 6757 2757 6793 6826 5042 5844 2340 6937 4133 5780 7020 
5 109 577 6858 5703 6880 1555 6871 6870 5844 2639 4764 3549 4988 6903 915 6911 6918 4926 6935 6961 1526 7016 3029 5015 2017 7105 4644 2629 4740 5046 7164 837 7168 2347 7155 2508 7172 4128 2956 7203 5892 7249 7195 1141 5447 7159 5891 7116 3582 7085 7066 2723 3317 4364 7048 7052 4432 3569 1301 2834 498 1528 376 2409 7082 1114 1993 2303 3988 3903 7080 2268 2467 7079 2139 7100 1285 7070 5825 1253 5282 6914 6920 3314 4006 1475 312 1597 5467 6907 1635 6837 5062 923 6771 1492 4572 6756 2756 6737 3058 6746 3379 6740 3427 6728 4249 6695 811 6692 
2 35 6806 4520 5298 4988 5721 3599 1077 3948 7040 5112 2252 7117 7142 578 7208 7236 7258 7280 7304 7338 3181 7397 7421 358 898 7535 7523 7574 2072 5063 4699 1396 4577 7698 7718 
5 74 668 7612 5541 5085 4106 175 3704 1714 3970 7437 5230 2149 3262 3594 4900 456 7370 3637 7323 440 2946 7324 1733 3828 7414 4663 1479 7371 7333 1298 5890 3826 5537 7357 318 5463 3596 4136 7299 598 5743 7309 5754 3686 4673 7346 1116 1766 2021 5329 7349 7368 1867 4541 2892 3691 5401 3843 5071 7251 3850 1417 7292 4899 3831 7339 5771 7325 1711 7286 4757 4923 7190 1141 
5 19 2629 4167 4674 7144 4539 7153 7141 3428 7113 5125 7102 5268 5112 2252 364 1419 5165 5681 7057 
5 56 2816 7108 837 7191 4351 5309 7287 7314 5605 7383 2790 2320 7490 4890 5654 7580 3503 7642 4415 7695 5376 7740 5620 2294 5853 3235 4738 346 3925 2661 2980 8040 8056 8079 2589 5402 8191 8219 3098 1066 8282 1646 4404 3647 8344 4239 4131 5747 8427 8435 3733 2590 3476 8472 1103 8473 
4 7 8330 5737 8374 8391 3488 8373 4239 
5 97 5963 8224 96 8213 8210 1430 8219 3526 880 5257 3188 2130 8250 3109 5592 8247 4142 8272 5170 8291 8273 3578 4645 8327 8325 8310 1104 2132 5494 8367 2487 8354 8370 8372 1648 8358 4579 3421 1551 8389 2827 4661 2909 5014 4593 8414 8430 2133 2931 3802 1511 8419 2415 1383 5055 8387 558 5828 8349 899 8340 8356 3082 8339 3154 8336 2733 8307 1637 8223 2524 8240 4369 2616 4762 3614 8254 39 990 8246 8222 5074 2842 3586 8117 1100 3801 4655 98 3840 2540 319 8046 3889 8023 8018 2783 
