5 85 5450 6552 6576 3553 6630 3993 2159 6690 6736 2403 701 2507 6832 577 6893 6919 6942 3868 6948 5087 1395 7020 7023 7057 5846 1341 2807 7134 7156 3721 7233 2798 7281 4272 7322 5799 4701 3847 7467 4626 5961 2091 1296 7617 2305 3301 4869 5264 7766 7781 7800 5497 2269 7862 1224 1967 7947 3664 7984 8034 3947 8058 8081 1537 8127 8152 4306 8199 5963 8265 5903 8293 5559 8330 8341 4845 8386 3842 5009 4191 4397 8459 527 8473 3964 
2 12 5561 6713 1352 6753 6767 4265 275 5382 6861 1555 1935 6948 
2 7 6724 6731 3539 6760 6767 606 2895 
2 9 6713 1928 5937 491 2895 6807 6825 769 6832 
2 12 2719 6757 2757 6793 6826 5042 5844 2340 6937 4133 5780 7020 
5 109 577 6858 5703 6880 1555 6871 6870 5844 2639 4764 3549 4988 6903 915 6911 6918 4926 6935 6961 1526 7016 3029 5015 2017 7105 4644 2629 4740 5046 7164 837 7168 2347 7155 2508 7172 4128 2956 7203 5892 7249 7195 1141 5447 7159 5891 7116 3582 7085 7066 2723 3317 4364 7048 7052 4432 3569 1301 2834 498 1528 376 2409 7082 1114 1993 2303 3988 3903 7080 2268 2467 7079 2139 7100 1285 7070 5825 1253 5282 6914 6920 3314 4006 1475 312 1597 5467 6907 1635 6837 5062 923 6771 1492 4572 6756 2756 6737 3058 6746 3379 6740 3427 6728 4249 6695 811 6692 
2 35 6806 4520 5298 4988 5721 3599 1077 3948 7040 5112 2252 7117 7142 578 7208 7236 7258 7280 7304 7338 3181 7397 7421 358 898 7535 7523 7574 2072 5063 4699 1396 4577 7698 7718 
5 110 3979 1395 5780 5517 595 6990 3948 3248 7039 7053 7072 7062 635 5393 4539 7170 5443 4674 4167 5546 7212 1883 4863 7250 7277 3182 7265 1861 7287 2299 5502 7254 7229 7222 4996 5945 3011 5542 7311 4757 7286 1711 7325 5771 7339 3831 4899 7292 1417 3850 7251 5071 3843 5401 3691 2892 4541 1867 7368 7349 5329 2021 1766 1116 7346 4673 3686 5754 7309 5743 598 7299 4136 3596 5463 318 7357 5537 3826 5890 1298 7333 7371 1479 4663 7414 3828 1733 7324 2946 440 7323 3637 7370 456 4900 3594 3262 2149 5230 7437 3970 1714 3704 175 4106 5085 5541 7612 668 
