5 85 5450 6552 6576 3553 6630 3993 2159 6690 6736 2403 701 2507 6832 577 6893 6919 6942 3868 6948 5087 1395 7020 7023 7057 5846 1341 2807 7134 7156 3721 7233 2798 7281 4272 7322 5799 4701 3847 7467 4626 5961 2091 1296 7617 2305 3301 4869 5264 7766 7781 7800 5497 2269 7862 1224 1967 7947 3664 7984 8034 3947 8058 8081 1537 8127 8152 4306 8199 5963 8265 5903 8293 5559 8330 8341 4845 8386 3842 5009 4191 4397 8459 527 8473 3964 
2 12 5561 6713 1352 6753 6767 4265 275 5382 6861 1555 1935 6948 
2 7 6724 6731 3539 6760 6767 606 2895 
2 9 6713 1928 5937 491 2895 6807 6825 769 6832 
2 12 2719 6757 2757 6793 6826 5042 5844 2340 6937 4133 5780 7020 
5 109 577 6858 5703 6880 1555 6871 6870 5844 2639 4764 3549 4988 6903 915 6911 6918 4926 6935 6961 1526 7016 3029 5015 2017 7105 4644 2629 4740 5046 7164 837 7168 2347 7155 2508 7172 4128 2956 7203 5892 7249 7195 1141 5447 7159 5891 7116 3582 7085 7066 2723 3317 4364 7048 7052 4432 3569 1301 2834 498 1528 376 2409 7082 1114 1993 2303 3988 3903 7080 2268 2467 7079 2139 7100 1285 7070 5825 1253 5282 6914 6920 3314 4006 1475 312 1597 5467 6907 1635 6837 5062 923 6771 1492 4572 6756 2756 6737 3058 6746 3379 6740 3427 6728 4249 6695 811 6692 
2 35 6806 4520 5298 4988 5721 3599 1077 3948 7040 5112 2252 7117 7142 578 7208 7236 7258 7280 7304 7338 3181 7397 7421 358 898 7535 7523 7574 2072 5063 4699 1396 4577 7698 7718 
5 74 1141 7190 4923 4757 7286 1711 7325 5771 7339 3831 4899 7292 1417 3850 7251 5071 3843 5401 3691 2892 4541 1867 7368 7349 5329 2021 1766 1116 7346 4673 3686 5754 7309 5743 598 7299 4136 3596 5463 318 7357 5537 3826 5890 1298 7333 7371 1479 4663 7414 3828 1733 7324 2946 440 7323 3637 7370 456 4900 3594 3262 2149 5230 7437 3970 1714 3704 175 4106 5085 5541 7612 668 
5 19 2629 4167 4674 7144 4539 7153 7141 3428 7113 5125 7102 5268 5112 2252 364 1419 5165 5681 7057 
5 56 2816 7108 837 7191 4351 5309 7287 7314 5605 7383 2790 2320 7490 4890 5654 7580 3503 7642 4415 7695 5376 7740 5620 2294 5853 3235 4738 346 3925 2661 2980 8040 8056 8079 2589 5402 8191 8219 3098 1066 8282 1646 4404 3647 8344 4239 4131 5747 8427 8435 3733 2590 3476 8472 1103 8473 
4 7 8330 5737 8374 8391 3488 8373 4239 
5 97 5963 8224 96 8213 8210 1430 8219 3526 880 5257 3188 2130 8250 3109 5592 8247 4142 8272 5170 8291 8273 3578 4645 8327 8325 8310 1104 2132 5494 8367 2487 8354 8370 8372 1648 8358 4579 3421 1551 8389 2827 4661 2909 5014 4593 8414 8430 2133 2931 3802 1511 8419 2415 1383 5055 8387 558 5828 8349 899 8340 8356 3082 8339 3154 8336 2733 8307 1637 8223 2524 8240 4369 2616 4762 3614 8254 39 990 8246 8222 5074 2842 3586 8117 1100 3801 4655 98 3840 2540 319 8046 3889 8023 8018 2783 
1 10 5015 4379 5712 1667 7038 5840 3574 2128 3248 3948 
1 5 1077 6955 1862 6912 2340 
1 14 6858 4831 3868 6948 1768 6939 4133 5517 595 5314 7031 7050 4776 7040 
1 6 2629 564 7212 7239 4589 7277 
5 83 7233 2853 7243 7220 7236 7258 2567 7301 7300 2141 3142 5351 7257 1229 7262 4817 4589 7277 1423 2650 5605 7369 5705 835 5522 3180 7444 424 3971 7472 251 7492 3683 7533 7556 7558 5608 7595 1088 7587 7576 7571 7541 7565 4573 7562 3349 1641 5906 7598 7626 3837 7643 313 1972 1376 7603 7621 7607 4755 5370 1540 7583 2630 7555 7525 4093 7515 7531 3266 7534 4102 2229 7579 967 7628 1434 3530 7640 1866 3744 7673 7664 
5 46 4546 1273 2751 3891 3889 4725 8015 5535 1365 4836 4698 3078 2875 5023 412 7813 2821 2879 7721 7693 7664 7631 7585 4091 1215 1113 1479 3442 7319 3917 5742 5149 7111 7081 7060 4130 6993 2067 1597 2152 2160 6833 1885 6808 2373 6699 
2 23 7319 1726 7209 7187 2434 5520 4730 2163 5507 3538 2047 6992 4789 457 6872 6864 4088 2260 632 1382 3662 6843 4430 
2 4 5742 7226 3946 7209 
2 6 4088 6836 130 6774 1284 6728 
5 59 6597 5202 4089 6673 6692 6710 6732 6738 3608 6770 5899 4430 6881 2358 6928 6959 1046 2841 7034 7065 7087 1760 1268 7201 7231 1912 7315 1548 7385 2244 7426 7459 5398 4106 7522 4554 3665 5649 2362 7655 1483 1749 865 3768 2177 3830 7846 3641 1876 7930 1406 7964 7966 2416 7997 2783 8041 4963 2751 
5 33 7100 4714 7193 338 7299 7334 2494 7394 2844 7480 4093 3628 3602 2433 7660 5011 1512 7748 5182 942 7857 7870 2126 7924 2917 7986 8008 3069 573 5304 680 3402 8223 
5 98 5535 8002 5902 1074 7975 5372 7982 8001 8006 8016 2888 8007 5338 7985 4406 894 4914 660 7951 1657 7986 2917 1847 537 7987 1977 7995 7983 118 7991 4612 7956 3144 1633 7962 4703 7 7971 2828 7948 2651 7919 7944 7933 7958 1203 7976 5471 300 3259 7992 4476 7977 2872 5246 7959 4618 7968 2410 4981 2018 4737 1451 1281 7818 678 4398 7772 7774 3300 5855 1718 611 7740 5376 7718 5914 7755 7768 3735 7760 3515 171 2175 7745 2990 4600 5629 526 2420 7654 2305 3523 7651 1355 5859 2111 3779 
5 38 5494 3552 4061 2935 8205 8187 5084 8108 8085 8057 8031 431 7972 3484 5525 4737 4410 3111 5587 4711 5689 3849 7632 1357 7556 552 7471 7452 7429 1214 1789 7336 1711 7268 4090 7207 7190 1141 
4 19 7026 7045 2816 7108 7121 4195 5577 3254 7127 2493 2015 5892 7249 7195 1141 7123 461 5205 3582 
3 7 7035 4750 3057 7071 4992 2687 2816 
4 38 7026 864 3079 3701 2307 7071 5414 7101 3254 7146 7172 7204 7229 7254 1145 7293 7331 7360 3417 5522 1259 7442 5939 4498 4231 7553 214 3705 7638 60 7694 1571 2692 3313 3240 7785 7804 1281 
3 7 6934 5684 6989 1115 7049 7056 5205 
3 6 5205 1587 7014 6985 4080 6934 
3 16 6927 4034 1175 7010 1763 2181 7085 7120 7138 7151 5210 7211 5824 7279 7308 5771 
3 14 5824 3758 7308 7339 1362 7380 1214 4544 7422 5288 5420 1011 2125 5522 
5 22 7556 7566 3480 3622 7543 7544 7545 7553 7538 3012 2122 7546 4799 2712 4890 7500 7493 4471 7456 2992 3694 7460 
3 32 2629 4167 5546 7215 7262 7295 7313 7347 4260 7390 7403 7428 7460 1441 7554 2237 7616 7633 1396 1225 7760 7806 2781 3761 4534 7819 30 2370 7862 7872 7897 2771 
3 12 5015 1097 565 4539 3250 3404 2141 7343 4552 5256 2910 7460 
3 16 1441 7520 5460 7574 7523 7535 7551 7559 7539 7517 4273 4626 2012 7469 179 4694 
5 4 7281 7270 3077 7280 
5 36 7467 7485 5863 7517 7539 7559 7589 7611 5469 7658 7677 4560 7745 380 7796 5279 7806 2926 2178 7880 2113 346 7957 5521 4086 5944 8055 5441 8103 1790 8155 4202 8180 4225 1393 5170 
3 8 2255 8034 2213 7981 4731 2351 482 2661 
5 31 8103 2444 3289 8088 8078 8049 2668 7973 3925 2661 7921 7911 4989 7876 7861 7835 7806 5279 7796 380 4453 2990 7720 7714 7710 7709 7680 7654 4833 7570 4273 
5 71 5497 3208 7822 30 7843 1379 4619 7909 2147 7911 7921 7903 2113 346 4738 7946 2815 7980 150 5603 8012 2640 8032 2598 5190 8103 1790 8155 1345 8133 1287 8132 8136 8131 3660 2010 8162 863 5084 8108 4905 8168 47 4087 5098 3518 4630 5938 8183 2824 8196 8189 2761 8188 4640 5452 3883 8185 4242 5017 8202 2460 2109 5964 5375 813 8241 8268 2724 2431 8340 
5 11 2827 8389 8375 8357 1731 2994 5793 3914 8242 3469 8185 
3 29 6685 6711 6727 2471 1628 6821 6854 120 4186 6979 2914 3926 2409 165 5312 7180 5787 1458 4438 4541 3341 2944 7427 5178 7481 7505 2580 7537 7562 
5 70 3400 1297 2094 3962 101 3782 6968 5725 2088 4145 1301 7078 2401 1381 7140 7184 7210 7237 3843 4752 7345 7375 7406 968 5795 4624 7528 4573 7562 3349 7622 5600 1887 1679 7691 4470 656 2121 4346 2110 5874 7896 2651 7949 2765 8003 3019 5286 8098 8119 8144 3306 8185 3469 8229 920 5436 8324 1205 3709 8385 1449 5117 1511 8441 579 1947 8488 1826 2975 
5 12 2827 8389 8375 8357 3757 8305 8287 5188 8233 1258 4662 8185 
2 6 4612 8009 1032 8069 1957 8138 
2 24 4175 1549 7990 2767 7948 2651 5377 7882 7865 1917 3696 1453 1547 7797 7780 3650 3408 7717 944 7674 4335 2817 7610 1357 
2 28 7562 7586 2894 4370 938 7757 7797 2456 7840 2076 7887 7918 3645 3259 1018 1738 2457 4426 2608 4630 3518 867 4787 5570 8318 8343 8346 8354 
5 40 2651 7919 7944 7933 1632 7901 7891 7878 7918 2933 3052 3893 2872 3562 7929 7913 4485 7905 2004 4737 1451 1281 4007 7847 7830 4398 7772 7774 3300 5855 5337 5222 2294 7828 2541 5331 7842 4287 1000 7806 
2 8 2567 3912 5646 951 3428 7095 7062 7038 
2 9 3948 6990 595 6956 6937 599 6904 1935 6880 
2 7 4552 7365 2077 1631 7332 3108 7280 
2 4 7304 4883 7327 7322 
3 10 4737 3954 267 7941 519 7937 4907 7989 2766 2640 
3 5 8133 8102 1389 5449 8032 
3 6 1389 253 8039 5271 4245 431 
1 8 3523 7618 7593 7560 2787 4211 4666 4694 
1 3 5300 7441 3847 
1 11 5853 7858 2773 7908 5242 5641 7892 3336 4069 7906 519 
3 29 3314 6892 4842 3396 4334 6876 6850 6842 207 1774 2535 6845 1562 6867 6851 999 2418 6821 1925 6862 530 4377 731 463 6947 6968 5725 7015 4432 
3 14 4546 5858 8156 3354 8145 645 8163 1699 140 711 4837 3910 8256 8246 
2 3 8246 453 1507 
3 6 8516 4887 2707 5545 8445 8441 
1 13 4661 8422 5967 4172 3601 3940 8451 5211 4296 2707 8500 5870 2975 
3 3 8542 8547 1133 
1 16 5841 8548 1133 4129 4906 8516 3906 8496 5956 8465 55 3601 4172 5967 8422 4661 
1 6 8547 8534 663 4906 8511 4887 
1 5 2975 8520 849 8511 4887 
5 3 8385 5487 8369 
1 22 8117 270 8065 857 7982 5372 1331 7894 3573 2875 1985 1053 4654 5437 556 4445 7634 2464 7557 2527 1589 7437 
1 14 5200 7829 5579 7809 7800 7770 7736 7714 5629 3729 5469 7630 184 7574 
1 5 7829 7810 1279 7788 7800 
1 11 7383 4339 7416 4070 7376 7389 7418 7433 2992 4221 1441 
1 3 577 6875 3880 
1 3 3880 827 577 
1 2 1395 3979 
1 8 5846 1164 5595 2148 1405 7194 3784 7134 
1 9 7156 5290 3718 7297 5627 1951 7353 7374 7425 
1 6 1951 5627 7318 7278 4607 7156 
1 2 3779 7810 
1 6 3779 1874 4958 4318 2797 7692 
1 3 2797 272 1355 
1 4 272 4581 4099 7618 
1 8 7618 5639 7605 4126 7590 7584 1190 2787 
1 3 4694 5212 4211 
1 4 4701 7388 3625 5784 
1 4 4701 3509 7366 7373 
1 4 7322 4272 3334 2547 
1 2 7281 7305 
1 2 2547 7305 
1 9 2132 8368 2407 8399 2887 8394 8393 2389 8354 
1 3 5494 8367 8383 
1 9 1977 8021 3898 360 3370 846 4332 8148 680 
5 6 668 7667 7649 3411 7690 865 
5 6 668 7602 1880 7547 881 7578 
1 2 3608 5796 
